'user_id','group_id'
'42','8'
'43','4'
'43','10'
'44','6'
'45','5'
'45','6'
'46','2'